7,7,7,7,7,7,7,20
39,15,15,15,15,15,15,20
39,15,15,15,15,15,15,20
39,15,15,15,15,15,15,20
39,15,15,15,15,15,15,20
39,15,15,15,15,15,15,20
39,15,15,15,15,15,15,20
39,15,15,15,15,15,15,20
39,15,15,15,15,15,15,20
39,15,15,15,15,15,15,20
39,15,15,15,15,15,15,20
39,15,15,15,15,15,15,20
39,15,15,15,15,15,15,20
39,15,15,15,15,15,15,20
39,15,15,15,15,15,15,20
39,15,15,15,15,15,15,20
39,15,15,15,15,15,15,20
39,15,15,15,15,15,15,20
39,15,15,15,15,15,15,20
26,26,26,26,26,26,26,20
